2023,2023-06-11,Botafogo RJ,Fortaleza,2,0,H,2,7,3,10,2,2,4,3,3,6,1,0,1
2023,2023-06-10,Atletico-MG,Bragantino,1,1,D,2,7,2,9,4,0,4,2,2,4,1,1,2
2023,2023-06-10,Bahia,Cruzeiro,2,2,D,4,6,5,11,1,1,2,5,1,6,1,2,3
2023,2023-06-10,Corinthians,Cuiaba,1,1,D,2,8,6,14,2,4,6,2,3,5,0,0,0
2023,2023-06-10,Coritiba,Santos,0,0,D,0,8,3,11,4,1,5,3,3,6,0,0,0
2023,2023-06-06,Vasco,Flamengo RJ,1,4,A,5,4,0,4,2,0,2,2,0,2,0,4,4
2023,2023-06-04,Santos,Internacional,1,1,D,2,5,5,10,2,4,6,2,4,6,1,1,2
2023,2023-06-04,Fluminense,Bragantino,2,1,H,3,6,7,13,4,5,9,5,2,7,2,0,2
2023,2023-06-04,Gremio,Sao Paulo,2,1,H,3,7,8,15,3,3,6,2,1,3,2,1,3
2023,2023-06-04,Goias,Cuiaba,0,1,A,1,4,5,9,3,3,6,2,3,5,0,0,0
2023,2023-06-04,Palmeiras,Coritiba,3,1,H,4,11,6,17,5,1,6,4,5,9,2,0,2
2023,2023-06-03,Fortaleza,Bahia,0,0,D,0,8,4,12,5,2,7,2,3,5,0,0,0
2023,2023-06-03,America MG,Corinthians,2,0,H,2,2,3,5,1,0,1,1,0,1,2,0,2
2023,2023-06-03,Athletico-PR,Botafogo RJ,1,0,H,1,6,7,13,3,6,9,3,1,4,1,0,1
2023,2023-06-03,Cruzeiro,Atletico-MG,0,1,A,1,12,4,16,5,3,8,6,5,11,0,1,1
2023,2023-05-28,Sao Paulo,Goias,2,1,H,3,11,5,16,5,4,9,2,4,6,0,1,1
2023,2023-05-28,Corinthians,Fluminense,2,0,H,2,7,6,13,4,5,9,4,2,6,0,0,0
2023,2023-05-28,Internacional,Bahia,2,0,H,2,2,6,8,2,0,2,1,2,3,1,0,1
2023,2023-05-28,Atletico-MG,Palmeiras,1,1,D,2,3,3,6,2,2,4,3,3,6,1,0,1
2023,2023-05-28,Bragantino,Santos,2,0,H,2,5,4,9,2,1,3,2,1,3,1,0,1
2023,2023-05-28,Botafogo RJ,America MG,2,0,H,2,7,0,7,3,0,3,2,3,5,1,0,1
2023,2023-05-27,Athletico-PR,Gremio,1,2,A,3,10,5,15,2,3,5,2,4,6,1,1,2
2023,2023-05-27,Fortaleza,Vasco,2,0,H,2,8,5,13,5,3,8,3,1,4,0,0,0
2023,2023-05-27,Cuiaba,Coritiba,1,1,D,2,2,6,8,2,0,2,3,5,8,1,0,1
2023,2023-05-27,Flamengo RJ,Cruzeiro,1,1,D,2,2,1,3,1,0,1,4,5,9,1,1,2
2023,2023-05-23,Cruzeiro,Cuiaba,0,1,A,1,6,2,8,3,1,4,1,3,4,0,1,1
2023,2023-05-21,Santos,Palmeiras,0,0,D,0,3,4,7,2,0,2,3,1,4,0,0,0
2023,2023-05-21,Flamengo RJ,Corinthians,1,0,H,1,6,9,15,5,4,9,0,2,2,0,0,0
2023,2023-05-21,Gremio,Internacional,3,1,H,4,3,7,10,1,2,3,3,1,4,2,0,2
2023,2023-05-20,Bahia,Goias,1,1,D,2,4,6,10,3,2,5,1,3,4,1,1,2
2023,2023-05-20,America MG,Fortaleza,2,1,H,3,1,2,3,1,1,2,4,2,6,2,1,3
2023,2023-05-20,Botafogo RJ,Fluminense,1,0,H,1,7,4,11,1,2,3,4,2,6,0,0,0
2023,2023-05-20,Bragantino,Athletico-PR,2,0,H,2,6,5,11,2,2,4,2,3,5,1,0,1
2023,2023-05-20,Coritiba,Atletico-MG,1,2,A,3,5,7,12,2,2,4,6,9,15,1,1,2
2023,2023-05-20,Sao Paulo,Vasco,4,2,H,6,3,9,12,1,7,8,0,4,4,2,1,3
2023,2023-05-14,Atletico-MG,Internacional,2,0,H,2,3,3,6,0,2,2,2,3,5,1,0,1
2023,2023-05-14,Corinthians,Sao Paulo,1,1,D,2,5,4,9,4,2,6,2,4,6,1,1,2
2023,2023-05-14,Gremio,Fortaleza,0,0,D,0,9,4,13,4,1,5,3,4,7,0,0,0
2023,2023-05-14,Vasco,Santos,0,1,A,1,13,1,14,4,0,4,4,1,5,0,1,1
2023,2023-05-14,America MG,Cruzeiro,0,4,A,4,5,6,11,1,5,6,2,0,2,0,1,1
2023,2023-05-14,Athletico-PR,Coritiba,3,2,H,5,4,1,5,1,1,2,3,3,6,0,1,1
2023,2023-05-14,Goias,Botafogo RJ,2,1,H,3,4,7,11,4,3,7,6,3,9,1,1,2
2023,2023-05-13,Bahia,Flamengo RJ,2,3,A,5,10,4,14,7,2,9,10,5,15,1,3,4
2023,2023-05-13,Fluminense,Cuiaba,2,0,H,2,7,3,10,4,1,5,3,4,7,1,0,1
2023,2023-05-13,Palmeiras,Bragantino,1,1,D,2,15,6,21,6,5,11,4,1,5,0,0,0
2023,2023-05-12,Fortaleza,Sao Paulo,0,0,D,0,4,10,14,2,4,6,3,6,9,0,0,0
2023,2023-05-11,Cuiaba,Atletico-MG,0,4,A,4,6,1,7,3,0,3,1,2,3,0,1,1
2023,2023-05-11,Flamengo RJ,Goias,2,0,H,2,8,7,15,2,4,6,0,1,1,1,0,1
2023,2023-05-11,Cruzeiro,Fluminense,0,2,A,2,16,3,19,5,2,7,1,6,7,0,1,1
2023,2023-05-11,Palmeiras,Gremio,4,1,H,5,7,4,11,2,1,3,2,4,6,1,1,2
2023,2023-05-11,Coritiba,Vasco,1,1,D,2,5,5,10,3,1,4,2,1,3,1,0,1
2023,2023-05-11,Botafogo RJ,Corinthians,3,0,H,3,3,3,6,2,2,4,1,2,3,1,0,1
2023,2023-05-10,Bragantino,America MG,2,2,D,4,5,4,9,2,4,6,5,3,8,2,1,3
2023,2023-05-10,Internacional,Athletico-PR,0,2,A,2,4,3,7,2,1,3,2,4,6,0,0,0
2023,2023-05-10,Santos,Bahia,3,0,H,3,1,4,5,0,0,0,3,4,7,2,0,2
2023,2023-05-09,Corinthians,Fortaleza,1,1,D,2,5,5,10,2,4,6,2,2,4,0,0,0
2023,2023-05-07,Fluminense,Vasco,1,1,D,2,9,1,10,3,1,4,3,3,6,0,1,1
2023,2023-05-07,America MG,Cuiaba,1,2,A,3,4,6,10,2,4,6,4,4,8,1,0,1
2023,2023-05-07,Athletico-PR,Flamengo RJ,2,1,H,3,2,8,10,0,3,3,2,2,4,1,1,2
2023,2023-05-07,Bahia,Coritiba,3,1,H,4,3,5,8,1,3,4,2,7,9,1,0,1
2023,2023-05-07,Sao Paulo,Internacional,2,0,H,2,4,9,13,2,3,5,3,4,7,1,0,1
2023,2023-05-07,Botafogo RJ,Atletico-MG,2,0,H,2,5,9,14,2,8,10,1,3,4,1,0,1
2023,2023-05-07,Goias,Palmeiras,0,5,A,5,4,6,10,2,3,5,3,6,9,0,1,1
2023,2023-05-07,Gremio,Bragantino,3,3,D,6,4,7,11,3,3,6,5,2,7,1,1,2
2023,2023-05-06,Cruzeiro,Santos,2,1,H,3,4,4,8,1,2,3,6,3,9,1,0,1
2023,2023-05-02,Vasco,Bahia,0,1,A,1,7,6,13,2,3,5,1,4,5,0,1,1
2023,2023-04-30,Atletico-MG,Athletico-PR,2,1,H,3,1,5,6,1,1,2,3,3,6,1,0,1
2023,2023-04-30,Flamengo RJ,Botafogo RJ,2,3,A,5,7,2,9,2,2,4,4,5,9,0,2,2
2023,2023-04-30,Cuiaba,Gremio,1,2,A,3,4,5,9,5,2,7,5,5,10,1,1,2
2023,2023-04-30,Internacional,Goias,1,0,H,1,8,11,19,5,4,9,4,3,7,0,0,0
2023,2023-04-29,Coritiba,Sao Paulo,1,1,D,2,7,6,13,2,3,5,4,1,5,1,0,1
2023,2023-04-29,Fortaleza,Fluminense,4,2,H,6,8,5,13,4,3,7,0,3,3,2,1,3
2023,2023-04-29,Bragantino,Cruzeiro,0,3,A,3,5,9,14,5,2,7,7,2,9,0,1,1
2023,2023-04-29,Palmeiras,Corinthians,2,1,H,3,12,3,15,6,1,7,3,3,6,2,0,2
2023,2023-04-29,Santos,America MG,3,2,H,5,2,6,8,2,3,5,4,4,8,2,1,3
2023,2023-04-25,Bahia,Botafogo RJ,1,2,A,3,6,3,9,4,1,5,1,2,3,1,1,2
2023,2023-04-23,Cruzeiro,Gremio,1,0,H,1,11,5,16,8,1,9,7,2,9,0,0,0
2023,2023-04-23,Internacional,Flamengo RJ,2,1,H,3,6,2,8,3,0,3,3,1,4,0,0,0
2023,2023-04-23,Santos,Atletico-MG,0,0,D,0,9,6,15,5,2,7,3,3,6,0,0,0
2023,2023-04-23,Vasco,Palmeiras,2,2,D,4,2,5,7,1,1,2,4,3,7,2,1,3
2023,2023-04-23,Coritiba,Fortaleza,0,3,A,3,3,7,10,3,3,6,1,2,3,0,0,0
2023,2023-04-23,Goias,Corinthians,3,1,H,4,5,8,13,2,4,6,5,2,7,1,1,2
2023,2023-04-22,Fluminense,Athletico-PR,2,0,H,2,10,6,16,7,2,9,3,3,6,1,0,1
2023,2023-04-22,Cuiaba,Bragantino,1,1,D,2,4,5,9,3,4,7,3,3,6,0,0,0
2023,2023-04-22,Sao Paulo,America MG,3,0,H,3,3,7,10,0,5,5,5,3,8,1,0,1
2023,2023-04-16,Atletico-MG,Vasco,1,2,A,3,14,3,17,6,2,8,6,5,11,1,2,3
2023,2023-04-16,Corinthians,Cruzeiro,2,1,H,3,7,4,11,3,0,3,4,2,6,0,0,0
2023,2023-04-16,Flamengo RJ,Coritiba,3,0,H,3,6,3,9,4,2,6,3,3,6,1,0,1
2023,2023-04-16,Gremio,Santos,1,0,H,1,4,11,15,3,7,10,3,5,8,1,0,1
2023,2023-04-15,America MG,Fluminense,0,3,A,3,11,1,12,8,0,8,3,2,5,0,0,0
2023,2023-04-15,Palmeiras,Cuiaba,2,1,H,3,4,4,8,1,1,2,2,6,8,1,1,2
2023,2023-04-15,Athletico-PR,Goias,2,0,H,2,3,8,11,3,5,8,2,3,5,1,0,1
2023,2023-04-15,Botafogo RJ,Sao Paulo,2,1,H,3,3,7,10,1,2,3,3,2,5,1,1,2
2023,2023-04-15,Bragantino,Bahia,2,1,H,3,4,7,11,2,0,2,1,1,2,0,1,1
2023,2023-04-15,Fortaleza,Internacional,1,1,D,2,5,1,6,2,0,2,2,1,3,0,0,0
2023,2023-06-11,America MG,Athletico-PR,2,2,D,4,7,3,10,6,2,8,2,4,6,0,1,1
2023,2023-06-11,Flamengo RJ,Gremio,3,0,H,3,3,7,10,1,1,2,0,3,3,1,0,1
2023,2023-06-11,Internacional,Vasco,2,1,H,3,7,6,13,1,3,4,2,3,5,2,1,3
2023,2023-06-11,Sao Paulo,Palmeiras,0,2,A,2,8,3,11,2,0,2,5,1,6,0,1,1
2023,2023-06-11,Goias,Fluminense,2,2,D,4,6,7,13,0,6,6,3,3,6,1,1,2
2023,2023-06-22,Fluminense,Atletico-MG,1,1,D,2,3,5,8,0,2,2,2,4,6,1,1,2
2023,2023-06-22,Bahia,Palmeiras,1,0,H,1,6,8,14,2,4,6,4,3,7,0,0,0
2023,2023-06-22,Santos,Corinthians,0,2,A,2,5,2,7,2,0,2,2,4,6,0,2,2
2023,2023-06-21,Sao Paulo,Athletico-PR,2,1,H,3,4,4,8,4,2,6,3,2,5,1,1,2
2023,2023-06-21,Cruzeiro,Fortaleza,0,1,A,1,5,2,7,2,1,3,4,4,8,0,0,0
2023,2023-06-23,Vasco,Goias,0,1,A,1,8,2,10,5,0,5,2,3,5,0,0,0
2023,2023-06-22,Gremio,America MG,3,1,H,4,10,2,12,6,1,7,0,4,4,1,1,2
2023,2023-06-23,Bragantino,Flamengo RJ,4,0,H,4,17,2,19,11,1,12,0,0,0,1,0,1
2023,2023-06-23,Coritiba,Internacional,0,1,A,1,10,5,15,7,2,9,2,4,6,0,0,0
2023,2023-06-23,Cuiaba,Botafogo RJ,0,1,A,1,6,2,8,3,0,3,2,2,4,0,0,0
2023,2023-06-24,Athletico-PR,Corinthians,1,0,H,1,5,5,10,4,2,6,5,2,7,1,0,1
2023,2023-06-24,Fluminense,Bahia,2,1,H,3,9,10,19,8,2,10,2,0,2,0,1,1
2023,2023-06-24,Fortaleza,Atletico-MG,2,1,H,3,3,8,11,2,3,5,1,1,2,0,0,0
2023,2023-06-25,Cruzeiro,Sao Paulo,1,0,H,1,6,5,11,3,3,6,1,3,4,1,0,1
2023,2023-06-25,Santos,Flamengo RJ,2,3,A,5,2,7,9,1,6,7,2,1,3,1,1,2
2023,2023-06-25,Gremio,Coritiba,5,1,H,6,8,5,13,4,3,7,2,5,7,1,1,2
2023,2023-06-25,Palmeiras,Botafogo RJ,0,1,A,1,12,1,13,6,2,8,0,3,3,0,1,1
2023,2023-06-25,America MG,Internacional,1,2,A,3,3,2,5,1,2,3,2,1,3,1,0,1
2023,2023-06-25,Bragantino,Goias,2,0,H,2,10,4,14,6,2,8,2,2,4,2,0,2
2023,2023-06-27,Vasco,Cuiaba,1,0,H,1,4,6,10,1,2,3,5,3,8,0,0,0
2023,2023-07-01,Sao Paulo,Fluminense,1,0,H,1,12,2,14,2,0,2,2,3,5,0,0,0
2023,2023-07-01,Bahia,Gremio,1,2,A,3,7,2,9,4,0,4,3,2,5,1,1,2
2023,2023-07-01,Flamengo RJ,Fortaleza,2,0,H,2,5,4,9,1,1,2,2,0,2,1,0,1
2023,2023-07-02,Internacional,Cruzeiro,0,0,D,0,2,4,6,2,1,3,6,5,11,0,0,0
2023,2023-07-02,Corinthians,Bragantino,0,1,A,1,4,2,6,0,1,1,3,2,5,0,1,1
2023,2023-07-02,Athletico-PR,Palmeiras,2,2,D,4,7,2,9,3,1,4,4,3,7,0,1,1
2023,2023-07-02,Atletico-MG,America MG,2,2,D,4,4,7,11,1,5,6,2,1,3,2,0,2
2023,2023-07-02,Botafogo RJ,Vasco,2,0,H,2,4,8,12,3,2,5,1,5,6,0,0,0
2023,2023-07-02,Cuiaba,Santos,3,0,H,3,9,5,14,5,4,9,0,2,2,0,0,0
2023,2023-07-04,Goias,Coritiba,1,2,A,3,7,2,9,4,2,6,5,8,13,0,2,2
2023,2023-07-08,Cuiaba,Bahia,1,1,D,2,5,5,10,3,0,3,2,3,5,1,0,1
2023,2023-07-08,Vasco,Cruzeiro,0,1,A,1,4,5,9,1,3,4,2,3,5,0,1,1
2023,2023-07-08,Atletico-MG,Corinthians,0,1,A,1,10,2,12,2,1,3,3,2,5,0,1,1
2023,2023-07-08,Coritiba,America MG,3,1,H,4,7,8,15,5,2,7,5,3,8,2,1,3
2023,2023-07-09,Palmeiras,Flamengo RJ,1,1,D,2,4,7,11,3,2,5,2,3,5,1,0,1
2023,2023-07-09,Santos,Goias,4,3,H,7,8,13,21,4,7,11,1,1,2,3,1,4
2023,2023-07-09,Fluminense,Internacional,2,0,H,2,7,4,11,3,0,3,2,3,5,2,0,2
2023,2023-07-09,Bragantino,Sao Paulo,0,0,D,0,6,4,10,3,3,6,2,2,4,0,0,0
2023,2023-07-09,Fortaleza,Athletico-PR,1,0,H,1,7,2,9,4,2,6,3,3,6,0,0,0
2023,2023-07-09,Gremio,Botafogo RJ,0,2,A,2,10,2,12,8,0,8,2,4,6,0,0,0
2023,2023-07-16,Botafogo RJ,Bragantino,2,0,H,2,4,11,15,4,2,6,1,1,2,0,0,0
2023,2023-07-16,Cruzeiro,Coritiba,0,0,D,0,11,8,19,5,3,8,1,4,5,0,0,0
2023,2023-07-16,Fluminense,Flamengo RJ,0,0,D,0,8,1,9,0,1,1,7,5,12,0,0,0
2023,2023-07-16,Fortaleza,Cuiaba,0,1,A,1,10,0,10,5,0,5,5,4,9,0,1,1
2023,2023-07-16,Sao Paulo,Santos,4,1,H,5,4,3,7,2,2,4,3,5,8,2,0,2
2023,2023-07-16,Athletico-PR,Bahia,2,0,H,2,5,3,8,1,2,3,2,1,3,2,0,2
2023,2023-07-16,Internacional,Palmeiras,0,0,D,0,4,7,11,2,2,4,1,3,4,0,0,0
2023,2023-07-18,Goias,Atletico-MG,0,0,D,0,6,4,10,3,0,3,5,5,10,0,0,0
2023,2023-07-22,Flamengo RJ,America MG,1,1,D,2,12,7,19,5,4,9,2,4,6,0,0,0
2023,2023-07-22,Palmeiras,Fortaleza,3,1,H,4,4,3,7,3,1,4,3,6,9,1,1,2
2023,2023-07-22,Bahia,Corinthians,0,0,D,0,11,5,16,6,2,8,3,2,5,0,0,0
2023,2023-07-22,Cuiaba,Sao Paulo,2,1,H,3,2,4,6,1,3,4,2,5,7,0,0,0
2023,2023-07-22,Gremio,Atletico-MG,1,0,H,1,3,8,11,2,3,5,3,4,7,1,0,1
2023,2023-07-23,Cruzeiro,Goias,0,1,A,1,13,1,14,3,0,3,4,5,9,0,1,1
2023,2023-07-23,Bragantino,Internacional,0,0,D,0,13,4,17,5,1,6,3,2,5,0,0,0
2023,2023-07-23,Santos,Botafogo RJ,2,2,D,4,2,8,10,1,2,3,3,3,6,1,0,1
2023,2023-07-23,Vasco,Athletico-PR,0,2,A,2,8,2,10,4,2,6,2,4,6,0,0,0
2023,2023-07-24,Coritiba,Fluminense,2,0,H,2,7,11,18,3,5,8,2,1,3,2,0,2
2023,2023-07-29,Fluminense,Santos,1,0,H,1,6,2,8,3,1,4,6,6,12,0,0,0
2023,2023-07-29,Athletico-PR,Cruzeiro,3,3,D,6,7,5,12,1,2,3,1,4,5,1,2,3
2023,2023-07-29,Internacional,Cuiaba,1,2,A,3,7,5,12,3,2,5,5,2,7,1,1,2
2023,2023-07-29,Corinthians,Vasco,3,1,H,4,0,6,6,0,1,1,2,0,2,1,0,1
2023,2023-07-29,Fortaleza,Bragantino,0,3,A,3,2,9,11,1,7,8,2,3,5,0,1,1
2023,2023-07-29,Atletico-MG,Flamengo RJ,1,2,A,3,7,2,9,3,1,4,3,5,8,1,0,1
2023,2023-07-30,Sao Paulo,Bahia,0,0,D,0,10,5,15,6,2,8,0,4,4,0,0,0
2023,2023-07-30,America MG,Palmeiras,1,4,A,5,5,4,9,3,3,6,2,1,3,1,2,3
2023,2023-07-30,Botafogo RJ,Coritiba,4,1,H,5,7,3,10,2,1,3,1,3,4,3,1,4
2023,2023-07-30,Goias,Gremio,1,1,D,2,6,5,11,1,2,3,4,2,6,0,0,0
2023,2023-08-05,Fluminense,Palmeiras,2,1,H,3,0,8,8,0,2,2,7,2,9,1,0,1
2023,2023-08-05,Santos,Athletico-PR,1,1,D,2,3,3,6,2,2,4,3,2,5,0,1,1
2023,2023-08-05,Internacional,Corinthians,2,2,D,4,1,4,5,1,2,3,5,3,8,1,1,2
2023,2023-08-05,Goias,Fortaleza,1,0,H,1,5,2,7,4,0,4,1,3,4,0,0,0
2023,2023-08-06,Sao Paulo,Atletico-MG,0,2,A,2,9,3,12,5,2,7,6,5,11,0,1,1
2023,2023-08-06,Vasco,Gremio,1,0,H,1,5,7,12,2,3,5,1,1,2,0,0,0
2023,2023-08-06,Cruzeiro,Botafogo RJ,0,0,D,0,8,1,9,4,0,4,1,2,3,0,0,0
2023,2023-08-06,Bahia,America MG,3,1,H,4,7,2,9,4,1,5,4,5,9,1,0,1
2023,2023-08-06,Coritiba,Bragantino,0,1,A,1,3,4,7,3,1,4,3,5,8,0,1,1
2023,2023-08-06,Cuiaba,Flamengo RJ,3,0,H,3,10,6,16,9,0,9,2,0,2,0,0,0
2023,2023-08-12,Botafogo RJ,Internacional,3,1,H,4,7,3,10,4,1,5,3,3,6,0,1,1
2023,2023-08-13,Atletico-MG,Bahia,1,0,H,1,2,9,11,1,4,5,2,1,3,0,0,0
2023,2023-08-13,America MG,Goias,0,1,A,1,7,3,10,3,1,4,0,1,1,0,1,1
2023,2023-08-13,Corinthians,Coritiba,3,1,H,4,4,2,6,1,2,3,2,2,4,0,1,1
2023,2023-08-13,Gremio,Fluminense,2,1,H,3,3,8,11,0,2,2,3,4,7,2,1,3
2023,2023-08-13,Fortaleza,Santos,4,0,H,4,10,6,16,5,2,7,2,1,3,0,0,0
2023,2023-08-13,Flamengo RJ,Sao Paulo,1,1,D,2,8,2,10,3,1,4,2,6,8,0,1,1
2023,2023-08-14,Palmeiras,Cruzeiro,1,0,H,1,3,5,8,1,3,4,2,3,5,0,0,0
2023,2023-08-14,Bragantino,Vasco,1,1,D,2,7,6,13,5,4,9,3,5,8,1,1,2
2023,2023-08-15,Athletico-PR,Cuiaba,2,0,H,2,5,3,8,5,2,7,5,3,8,1,0,1
2023,2023-08-19,Cuiaba,Palmeiras,0,2,A,2,9,2,11,2,1,3,2,6,8,0,1,1
2023,2023-08-19,Internacional,Fortaleza,0,1,A,1,10,6,16,2,3,5,4,5,9,0,1,1
2023,2023-08-19,Sao Paulo,Botafogo RJ,0,0,D,0,5,2,7,2,0,2,4,2,6,0,0,0
2023,2023-08-19,Cruzeiro,Corinthians,1,1,D,2,10,3,13,6,0,6,3,3,6,1,0,1
2023,2023-08-20,Vasco,Atletico-MG,1,0,H,1,3,7,10,2,1,3,6,3,9,1,0,1
2023,2023-08-20,Bahia,Bragantino,4,0,H,4,4,7,11,3,3,6,2,5,7,2,0,2
2023,2023-08-20,Coritiba,Flamengo RJ,2,3,A,5,4,5,9,2,3,5,3,3,6,1,2,3
2023,2023-08-20,Santos,Gremio,2,1,H,3,9,4,13,6,1,7,6,7,13,0,0,0
2023,2023-08-21,Goias,Athletico-PR,1,1,D,2,4,7,11,1,4,5,2,4,6,0,1,1
2023,2023-08-26,Flamengo RJ,Internacional,0,0,D,0,6,3,9,1,3,4,2,4,6,0,0,0
2023,2023-08-26,Corinthians,Goias,1,1,D,2,7,6,13,2,3,5,3,1,4,0,0,0
2023,2023-08-27,Bragantino,Cuiaba,2,0,H,2,11,4,15,6,0,6,4,3,7,0,0,0
2023,2023-08-27,America MG,Sao Paulo,2,1,H,3,4,6,10,4,3,7,7,2,9,0,0,0
2023,2023-08-19,Fluminense,America MG,3,1,H,4,7,1,8,6,0,6,1,1,2,0,0,0
2023,2023-08-27,Atletico-MG,Santos,2,0,H,2,5,2,7,0,1,1,5,2,7,1,0,1
2023,2023-08-27,Botafogo RJ,Bahia,3,0,H,3,4,7,11,2,3,5,2,3,5,1,0,1
2023,2023-08-27,Palmeiras,Vasco,1,0,H,1,9,2,11,6,1,7,2,3,5,0,0,0
2023,2023-08-27,Athletico-PR,Fluminense,2,2,D,4,2,8,10,1,5,6,3,3,6,1,0,1
2023,2023-08-27,Fortaleza,Coritiba,3,1,H,4,2,3,5,1,1,2,3,6,9,2,0,2
2023,2023-08-27,Gremio,Cruzeiro,3,0,H,3,6,5,11,5,2,7,4,3,7,1,0,1
2023,2023-09-02,Athletico-PR,Atletico-MG,1,1,D,2,12,7,19,5,5,10,4,3,7,0,1,1
2023,2023-09-02,Goias,Internacional,0,0,D,0,5,5,10,2,4,6,5,4,9,0,0,0
2023,2023-09-03,Botafogo RJ,Flamengo RJ,1,2,A,3,12,6,18,2,6,8,4,3,7,1,1,2
2023,2023-09-03,Gremio,Cuiaba,2,0,H,2,2,9,11,2,5,7,2,1,3,1,0,1
2023,2023-09-03,Corinthians,Palmeiras,0,0,D,0,2,11,13,2,8,10,2,5,7,0,0,0
2023,2023-09-03,Fluminense,Fortaleza,1,0,H,1,5,7,12,1,2,3,4,3,7,0,0,0
2023,2023-09-03,America MG,Santos,2,0,H,2,3,5,8,3,4,7,1,5,6,1,0,1
2023,2023-09-03,Bahia,Vasco,1,1,D,2,6,0,6,1,0,1,2,4,6,1,0,1
2023,2023-09-03,Cruzeiro,Bragantino,0,0,D,0,8,5,13,6,2,8,1,5,6,0,0,0
2023,2023-09-14,Flamengo RJ,Athletico-PR,0,3,A,3,8,2,10,5,1,6,3,2,5,0,1,1
2023,2023-09-14,Internacional,Sao Paulo,2,1,H,3,4,7,11,2,3,5,5,4,9,0,1,1
2023,2023-09-14,Fortaleza,Corinthians,2,1,H,3,6,3,9,2,1,3,1,2,3,1,1,2
2023,2023-09-14,Santos,Cruzeiro,0,3,A,3,8,9,17,5,6,11,3,2,5,0,1,1
2023,2023-09-15,Coritiba,Bahia,2,4,A,6,7,2,9,4,2,6,3,1,4,1,3,4
2023,2023-09-15,Bragantino,Gremio,2,0,H,2,5,1,6,4,0,4,4,2,6,2,0,2
2023,2023-09-16,Cuiaba,America MG,2,2,D,4,9,1,10,3,0,3,1,5,6,2,2,4
2023,2023-09-16,Palmeiras,Goias,1,0,H,1,6,3,9,1,2,3,3,4,7,0,0,0
2023,2023-09-16,Vasco,Fluminense,4,2,H,6,4,11,15,3,4,7,4,1,5,1,0,1
2023,2023-09-17,Atletico-MG,Botafogo RJ,1,0,H,1,5,3,8,4,1,5,2,1,3,0,0,0
2023,2023-09-20,America MG,Bragantino,0,2,A,2,2,14,16,1,7,8,1,2,3,0,1,1
2023,2023-09-20,Goias,Flamengo RJ,0,0,D,0,3,2,5,2,0,2,1,3,4,0,0,0
2023,2023-09-19,Bahia,Santos,1,2,A,3,6,8,14,3,3,6,1,2,3,0,0,0
2023,2023-09-21,Fluminense,Cruzeiro,1,0,H,1,7,3,10,3,1,4,6,1,7,0,0,0
2023,2023-09-21,Sao Paulo,Fortaleza,1,2,A,3,9,0,9,6,0,6,3,6,9,0,1,1
2023,2023-09-21,Vasco,Coritiba,5,1,H,6,6,0,6,4,0,4,1,3,4,2,0,2
2023,2023-09-21,Athletico-PR,Internacional,2,1,H,3,7,5,12,1,1,2,3,5,8,1,1,2
2023,2023-09-22,Gremio,Palmeiras,1,0,H,1,2,11,13,0,3,3,6,3,9,1,0,1
2023,2023-09-23,Corinthians,Botafogo RJ,1,0,H,1,6,1,7,1,0,1,4,5,9,0,0,0
2023,2023-09-24,Atletico-MG,Cuiaba,1,0,H,1,6,3,9,2,0,2,3,4,7,1,0,1
2023,2023-09-26,America MG,Vasco,0,1,A,1,3,8,11,3,1,4,4,2,6,0,0,0
2023,2023-09-27,Sao Paulo,Coritiba,2,1,H,3,4,3,7,2,1,3,2,3,5,2,1,3
2023,2023-09-30,Flamengo RJ,Bahia,1,0,H,1,12,2,14,5,1,6,1,3,4,0,0,0
2023,2023-09-30,Fortaleza,Gremio,1,1,D,2,3,7,10,3,1,4,1,2,3,1,0,1
2023,2023-09-30,Cuiaba,Fluminense,3,0,H,3,7,0,7,4,0,4,3,5,8,0,0,0
2023,2023-09-30,Sao Paulo,Corinthians,2,1,H,3,11,4,15,6,1,7,5,2,7,2,1,3
2023,2023-10-01,Internacional,Atletico-MG,0,2,A,2,4,4,8,0,1,1,0,0,0,0,0,0
2023,2023-10-01,Santos,Vasco,4,1,H,5,5,11,16,3,9,12,7,2,9,3,1,4
2023,2023-10-01,Cruzeiro,America MG,1,1,D,2,9,7,16,4,3,7,4,3,7,1,1,2
2023,2023-10-01,Coritiba,Athletico-PR,2,0,H,2,2,11,13,0,5,5,2,4,6,2,0,2
2023,2023-10-01,Bragantino,Palmeiras,2,1,H,3,6,4,10,1,3,4,4,2,6,0,1,1
2023,2023-10-02,Botafogo RJ,Goias,1,1,D,2,8,3,11,5,3,8,4,4,8,0,1,1
2023,2023-10-07,Vasco,Sao Paulo,0,0,D,0,7,3,10,5,2,7,3,1,4,0,0,0
2023,2023-10-07,Goias,Bahia,4,6,A,10,6,4,10,4,4,8,2,6,8,3,3,6
2023,2023-10-07,Corinthians,Flamengo RJ,1,1,D,2,2,8,10,1,6,7,3,3,6,0,0,0
2023,2023-10-08,Fluminense,Botafogo RJ,0,2,A,2,3,2,5,1,1,2,2,2,4,0,2,2
2023,2023-10-08,Internacional,Gremio,3,2,H,5,4,1,5,3,1,4,6,4,10,1,0,1
2023,2023-10-08,Palmeiras,Santos,1,2,A,3,6,2,8,3,1,4,2,3,5,1,1,2
2023,2023-10-08,Athletico-PR,Bragantino,1,1,D,2,8,7,15,4,6,10,2,4,6,1,1,2
2023,2023-10-08,Atletico-MG,Coritiba,1,2,A,3,2,5,7,0,5,5,2,2,4,0,0,0
2023,2023-10-08,Fortaleza,America MG,3,2,H,5,8,2,10,3,1,4,2,1,3,1,2,3
2023,2023-09-19,Corinthians,Gremio,4,4,D,8,6,4,10,2,0,2,1,1,2,3,2,5
2023,2023-10-14,Cuiaba,Cruzeiro,0,0,D,0,5,5,10,2,1,3,0,3,3,0,0,0
2023,2023-10-18,Gremio,Athletico-PR,1,2,A,3,4,8,12,0,5,5,3,6,9,1,1,2
2023,2023-10-18,America MG,Botafogo RJ,1,2,A,3,12,1,13,3,0,3,1,1,2,1,1,2
2023,2023-10-18,Coritiba,Cuiaba,0,3,A,3,4,4,8,1,2,3,0,2,2,0,1,1
2023,2023-10-18,Bahia,Internacional,1,0,H,1,5,3,8,1,2,3,1,2,3,1,0,1
2023,2023-10-18,Goias,Sao Paulo,2,0,H,2,6,3,9,1,1,2,4,3,7,2,0,2
2023,2023-10-18,Vasco,Fortaleza,1,0,H,1,6,6,12,3,2,5,3,2,5,0,0,0
2023,2023-10-19,Cruzeiro,Flamengo RJ,0,2,A,2,9,3,12,1,1,2,3,2,5,0,2,2
2023,2023-10-19,Palmeiras,Atletico-MG,0,2,A,2,7,2,9,3,2,5,6,3,9,0,1,1
2023,2023-10-19,Santos,Bragantino,1,3,A,4,5,4,9,5,2,7,4,1,5,0,2,2
2023,2023-10-19,Fluminense,Corinthians,3,3,D,6,15,1,16,4,1,5,9,3,12,1,3,4
2023,2023-10-21,Bahia,Fortaleza,2,0,H,2,7,2,9,4,0,4,6,4,10,1,0,1
2023,2023-10-21,Cuiaba,Goias,1,1,D,2,13,2,15,4,2,6,1,3,4,0,1,1
2023,2023-10-21,Sao Paulo,Gremio,3,0,H,3,6,3,9,3,0,3,1,3,4,1,0,1
2023,2023-10-21,Botafogo RJ,Athletico-PR,1,1,D,2,6,3,9,3,1,4,2,1,3,1,1,2
2023,2023-10-22,Atletico-MG,Cruzeiro,0,1,A,1,1,7,8,1,1,2,3,3,6,0,0,0
2023,2023-10-22,Flamengo RJ,Vasco,1,0,H,1,7,8,15,5,3,8,1,2,3,0,0,0
2023,2023-10-22,Internacional,Santos,7,1,H,8,3,6,9,1,5,6,1,1,2,4,0,4
2023,2023-10-22,Corinthians,America MG,1,1,D,2,4,4,8,2,2,4,2,3,5,0,1,1
2023,2023-10-22,Coritiba,Palmeiras,0,2,A,2,3,6,9,1,4,5,1,1,2,0,2,2
2023,2023-10-22,Bragantino,Fluminense,1,0,H,1,7,3,10,1,3,4,3,2,5,1,0,1
2023,2023-10-25,Athletico-PR,America MG,3,2,H,5,14,5,19,8,1,9,0,1,1,3,1,4
2023,2023-10-25,Fluminense,Goias,5,3,H,8,6,1,7,3,1,4,4,2,6,2,2,4
2023,2023-10-25,Bragantino,Atletico-MG,1,2,A,3,17,5,22,2,4,6,2,4,6,0,1,1
2023,2023-10-25,Cruzeiro,Bahia,3,0,H,3,1,2,3,0,1,1,2,2,4,1,0,1
2023,2023-10-25,Palmeiras,Sao Paulo,5,0,H,5,5,0,5,1,0,1,3,5,8,3,0,3
2023,2023-10-25,Cuiaba,Corinthians,0,1,A,1,6,5,11,4,4,8,1,3,4,0,0,0
2023,2023-10-25,Gremio,Flamengo RJ,3,2,H,5,6,1,7,3,0,3,3,4,7,0,1,1
2023,2023-10-26,Vasco,Internacional,1,2,A,3,7,1,8,1,0,1,7,4,11,0,1,1
2023,2023-10-26,Santos,Coritiba,2,1,H,3,11,2,13,5,1,6,2,6,8,1,1,2
2023,2023-10-28,America MG,Gremio,3,4,A,7,5,7,12,3,2,5,0,2,2,2,2,4
2023,2023-10-28,Palmeiras,Bahia,1,0,H,1,6,1,7,3,0,3,1,5,6,1,0,1
2023,2023-10-28,Atletico-MG,Fluminense,2,0,H,2,9,4,13,6,1,7,2,1,3,0,0,0
2023,2023-10-29,Athletico-PR,Sao Paulo,1,1,D,2,4,3,7,2,3,5,1,5,6,1,1,2
2023,2023-10-29,Goias,Vasco,1,1,D,2,7,2,9,1,0,1,2,6,8,0,0,0
2023,2023-10-29,Corinthians,Santos,1,1,D,2,10,3,13,8,1,9,6,2,8,0,0,0
2023,2023-10-29,Internacional,Coritiba,3,4,A,7,5,1,6,2,0,2,7,5,12,1,2,3
2023,2023-10-29,Botafogo RJ,Cuiaba,0,1,A,1,7,2,9,2,1,3,1,5,6,0,0,0
2023,2023-10-31,Bahia,Fluminense,1,0,H,1,2,4,6,1,2,3,2,3,5,1,0,1
2023,2023-11-01,Corinthians,Athletico-PR,1,0,H,1,1,7,8,0,3,3,1,2,3,0,0,0
2023,2023-11-01,Internacional,America MG,1,1,D,2,3,5,8,1,1,2,0,2,2,1,0,1
2023,2023-11-01,Coritiba,Gremio,1,2,A,3,6,11,17,4,7,11,3,2,5,0,1,1
2023,2023-11-01,Flamengo RJ,Santos,1,2,A,3,1,6,7,1,4,5,4,4,8,1,1,2
2023,2023-11-01,Atletico-MG,Fortaleza,3,1,H,4,0,4,4,0,2,2,0,2,2,1,1,2
2023,2023-11-01,Botafogo RJ,Palmeiras,3,4,A,7,2,6,8,2,1,3,7,5,12,3,0,3
2023,2023-11-02,Cuiaba,Vasco,0,2,A,2,5,1,6,1,1,2,2,1,3,0,0,0
2023,2023-11-02,Goias,Bragantino,0,2,A,2,10,7,17,2,6,8,3,3,6,0,1,1
2023,2023-11-02,Sao Paulo,Cruzeiro,1,0,H,1,3,4,7,1,2,3,1,4,5,0,0,0
2023,2023-11-04,America MG,Atletico-MG,1,1,D,2,0,4,4,0,2,2,4,3,7,0,0,0
2023,2023-11-04,Gremio,Bahia,1,0,H,1,5,4,9,2,0,2,2,4,6,0,0,0
2023,2023-11-04,Palmeiras,Athletico-PR,1,0,H,1,2,2,4,1,2,3,3,4,7,1,0,1
2023,2023-11-05,Cruzeiro,Internacional,1,2,A,3,8,1,9,4,1,5,2,1,3,0,1,1
2023,2023-11-05,Fortaleza,Flamengo RJ,0,2,A,2,4,3,7,2,2,4,1,3,4,0,1,1
2023,2023-11-05,Bragantino,Corinthians,1,0,H,1,10,6,16,5,1,6,1,2,3,1,0,1
2023,2023-11-05,Coritiba,Goias,0,1,A,1,5,9,14,2,4,6,3,3,6,0,0,0
2023,2023-11-06,Vasco,Botafogo RJ,1,0,H,1,4,4,8,2,2,4,2,4,6,1,0,1
2023,2023-11-06,Santos,Cuiaba,0,0,D,0,4,4,8,3,1,4,1,2,3,0,0,0
2023,2023-11-08,Flamengo RJ,Palmeiras,3,0,H,3,4,5,9,2,3,5,1,2,3,2,0,2
2023,2023-11-08,America MG,Coritiba,0,3,A,3,8,4,12,3,1,4,0,1,1,0,2,2
2023,2023-11-08,Internacional,Fluminense,0,0,D,0,5,3,8,4,1,5,2,2,4,0,0,0
2023,2023-11-08,Athletico-PR,Fortaleza,1,1,D,2,15,2,17,6,2,8,1,0,1,0,0,0
2023,2023-11-08,Sao Paulo,Bragantino,1,0,H,1,9,5,14,3,0,3,2,2,4,0,0,0
2023,2023-11-09,Corinthians,Atletico-MG,1,1,D,2,5,6,11,4,3,7,1,4,5,1,0,1
2023,2023-11-09,Goias,Santos,0,1,A,1,5,6,11,4,4,8,2,1,3,0,0,0
2023,2023-11-09,Bahia,Cuiaba,0,3,A,3,7,4,11,3,1,4,2,3,5,0,1,1
2023,2023-11-09,Botafogo RJ,Gremio,3,4,A,7,2,6,8,2,2,4,0,2,2,2,1,3
2023,2023-11-12,Gremio,Corinthians,0,1,A,1,12,1,13,4,1,5,3,7,10,0,1,1
2023,2023-11-12,Bragantino,Botafogo RJ,2,2,D,4,7,3,10,3,1,4,2,1,3,1,2,3
2023,2023-11-12,Atletico-MG,Goias,2,1,H,3,3,7,10,3,1,4,2,2,4,1,0,1
2023,2023-11-12,Bahia,Athletico-PR,1,1,D,2,11,5,16,6,1,7,3,4,7,0,0,0
2023,2023-11-12,Cuiaba,Fortaleza,2,1,H,3,2,9,11,2,5,7,1,2,3,1,0,1
2023,2023-11-12,Santos,Sao Paulo,0,0,D,0,1,4,5,0,4,4,0,2,2,0,0,0
2023,2023-11-12,Vasco,America MG,2,1,H,3,7,8,15,2,5,7,1,1,2,1,1,2
2023,2023-11-11,Flamengo RJ,Fluminense,1,1,D,2,5,2,7,4,1,5,2,5,7,1,0,1
2023,2023-11-11,Palmeiras,Internacional,3,0,H,3,6,3,9,4,2,6,1,2,3,1,0,1
2023,2023-11-11,Coritiba,Cruzeiro,1,0,H,1,1,5,6,0,2,2,4,4,8,0,0,0
2023,2023-11-18,Fortaleza,Cruzeiro,0,1,A,1,11,1,12,3,1,4,1,1,2,0,0,0
2023,2023-11-22,Cruzeiro,Vasco,2,2,D,4,7,5,12,2,2,4,1,1,2,2,1,3
2023,2023-11-22,Fluminense,Sao Paulo,1,0,H,1,3,4,7,2,2,4,6,6,12,0,0,0
2023,2023-11-23,Flamengo RJ,Bragantino,1,0,H,1,8,6,14,3,3,6,4,4,8,0,0,0
2023,2023-11-23,Fortaleza,Botafogo RJ,2,2,D,4,4,5,9,1,1,2,2,4,6,2,1,3
2023,2023-11-24,Corinthians,Bahia,1,5,A,6,3,3,6,2,2,4,2,3,5,0,3,3
2023,2023-11-25,Athletico-PR,Vasco,0,0,D,0,5,1,6,3,0,3,1,4,5,0,0,0
2023,2023-11-25,Fluminense,Coritiba,2,1,H,3,6,5,11,2,2,4,2,2,4,1,0,1
2023,2023-11-26,Atletico-MG,Gremio,3,0,H,3,7,7,14,6,2,8,3,2,5,1,0,1
2023,2023-11-26,Botafogo RJ,Santos,1,1,D,2,4,5,9,4,2,6,2,3,5,1,0,1
2023,2023-11-26,America MG,Flamengo RJ,0,3,A,3,3,7,10,2,3,5,4,4,8,0,1,1
2023,2023-11-26,Fortaleza,Palmeiras,2,2,D,4,4,7,11,1,3,4,2,3,5,1,0,1
2023,2023-11-26,Internacional,Bragantino,1,0,H,1,4,7,11,1,4,5,5,5,10,1,0,1
2023,2023-11-26,Sao Paulo,Cuiaba,0,0,D,0,5,1,6,2,1,3,2,0,2,0,0,0
2023,2023-11-27,Goias,Cruzeiro,0,1,A,1,4,5,9,0,1,1,3,3,6,0,0,0
2023,2023-11-28,Corinthians,Vasco,2,4,A,6,8,3,11,0,2,2,3,2,5,2,2,4
2023,2023-11-29,Santos,Fluminense,0,3,A,3,5,3,8,1,3,4,2,3,5,0,2,2
2023,2023-11-29,Flamengo RJ,Atletico-MG,0,3,A,3,10,1,11,3,1,4,3,2,5,0,1,1
2023,2023-11-29,Cuiaba,Internacional,0,2,A,2,2,5,7,2,3,5,3,2,5,0,0,0
2023,2023-11-29,Bahia,Sao Paulo,0,1,A,1,3,5,8,1,3,4,4,3,7,0,0,0
2023,2023-11-29,Coritiba,Botafogo RJ,1,1,D,2,3,10,13,2,3,5,5,2,7,0,0,0
2023,2023-11-29,Palmeiras,America MG,4,0,H,4,10,2,12,5,0,5,2,2,4,2,0,2
2023,2023-11-30,Gremio,Goias,2,1,H,3,6,3,9,1,1,2,3,2,5,0,1,1
2023,2023-11-30,Cruzeiro,Athletico-PR,1,1,D,2,2,3,5,1,0,1,3,4,7,0,0,0
2023,2023-11-30,Bragantino,Fortaleza,1,2,A,3,15,3,18,8,0,8,3,4,7,1,2,3
2023,2023-12-02,Corinthians,Internacional,1,2,A,3,5,4,9,3,3,6,3,2,5,0,1,1
2023,2023-12-02,Atletico-MG,Sao Paulo,2,1,H,3,3,5,8,3,3,6,4,1,5,0,0,0
2023,2023-12-03,Palmeiras,Fluminense,1,0,H,1,7,1,8,3,1,4,1,3,4,1,0,1
2023,2023-12-03,Flamengo RJ,Cuiaba,2,1,H,3,6,2,8,5,0,5,2,1,3,2,0,2
2023,2023-12-03,Bragantino,Coritiba,1,0,H,1,12,6,18,9,1,10,4,1,5,0,0,0
2023,2023-12-03,America MG,Bahia,3,2,H,5,2,10,12,2,4,6,3,0,3,2,1,3
2023,2023-12-03,Fortaleza,Goias,1,0,H,1,4,2,6,2,2,4,2,4,6,1,0,1
2023,2023-12-03,Athletico-PR,Santos,3,0,H,3,6,6,12,5,3,8,5,4,9,1,0,1
2023,2023-12-03,Botafogo RJ,Cruzeiro,0,0,D,0,6,2,8,2,1,3,4,3,7,0,0,0
2023,2023-12-03,Gremio,Vasco,1,0,H,1,5,6,11,5,4,9,3,1,4,0,0,0
2023,2023-12-06,Goias,America MG,1,0,H,1,8,7,15,3,4,7,2,2,4,1,0,1
2023,2023-12-06,Cuiaba,Athletico-PR,3,0,H,3,5,9,14,2,1,3,5,3,8,2,0,2
2023,2023-12-06,Internacional,Botafogo RJ,3,1,H,4,1,5,6,0,3,3,1,2,3,1,0,1
2023,2023-12-06,Coritiba,Corinthians,0,2,A,2,6,6,12,4,3,7,1,0,1,0,2,2
2023,2023-12-06,Fluminense,Gremio,2,3,A,5,7,3,10,2,3,5,3,3,6,1,2,3
2023,2023-12-06,Santos,Fortaleza,1,2,A,3,10,6,16,4,6,10,2,3,5,0,1,1
2023,2023-12-06,Vasco,Bragantino,2,1,H,3,2,3,5,0,1,1,3,2,5,1,0,1
2023,2023-12-06,Bahia,Atletico-MG,4,1,H,5,3,5,8,3,1,4,2,2,4,2,1,3
2023,2023-12-06,Cruzeiro,Palmeiras,1,1,D,2,3,4,7,2,1,3,1,1,2,0,1,1
2023,2023-12-06,Sao Paulo,Flamengo RJ,1,0,H,1,4,9,13,0,3,3,0,3,3,1,0,1
